#level1
****************
*  0           *
*         *    *
*              *
*              *
*        3     *
*     *  3     *
*        4     *
* **111115**   *
*              *
*        6     *
*    23  7     *
*    *         *
*              *
*  *******     *
*              *
*              *
*    22222     *
*              *
*    22222     *
*        *     *
*              *
*     333   4  *
****************